gene,mutation,position,type,BA1_analysis_cli,BA2_analysis_cli,sum
E,T9I,9,sub,80,80,160
M,D3G,3,sub,70,0,70
M,Q19E,19,sub,78,71,149
M,A63T,63,sub,80,80,160
N,P13L,13,sub,80,78,158
N,E31-,31,del,80,79,159
N,R32-,32,del,80,79,159
N,S33-,33,del,80,79,159
N,R203K,203,sub,80,79,159
N,G204R,204,sub,80,79,159
N,S413R,413,sub,0,78,78
ORF1a,S135R,135,sub,0,80,80
ORF1a,I694T,694,sub,13,0,13
ORF1a,T842I,842,sub,0,79,79
ORF1a,K856R,856,sub,80,0,80
ORF1a,G1307S,1307,sub,0,79,79
ORF1a,T1543I,1543,sub,0,7,7
ORF1a,S2083I,2083,sub,80,0,80
ORF1a,L2084-,2084,del,80,0,80
ORF1a,I2138V,2138,sub,8,0,8
ORF1a,A2710T,2710,sub,80,0,80
ORF1a,L3027F,3027,sub,0,76,76
ORF1a,T3090I,3090,sub,0,79,79
ORF1a,L3201F,3201,sub,0,78,78
ORF1a,T3255I,3255,sub,80,79,159
ORF1a,P3395H,3395,sub,80,80,160
ORF1a,L3674-,3674,del,80,0,80
ORF1a,S3675-,3675,del,80,80,160
ORF1a,G3676-,3676,del,80,80,160
ORF1a,F3677-,3677,del,0,80,80
ORF1a,I3758V,3758,sub,80,0,80
ORF1b,P314L,314,sub,80,80,160
ORF1b,R1315C,1315,sub,0,79,79
ORF1b,I1566V,1566,sub,80,80,160
ORF1b,T2163I,2163,sub,0,78,78
ORF3a,T223I,223,sub,0,79,79
ORF6,D61L,61,sub,0,77,77
ORF9b,P10S,10,sub,80,76,156
ORF9b,E27-,27,del,80,79,159
ORF9b,N28-,28,del,80,79,159
ORF9b,A29-,29,del,80,79,159
S,T19I,19,sub,0,79,79
S,L24S,24,sub,0,79,79
S,P25-,25,del,0,79,79
S,P26-,26,del,0,79,79
S,A27-,27,del,0,79,79
S,A67V,67,sub,80,0,80
S,H69-,69,del,80,0,80
S,V70-,70,del,80,0,80
S,T95I,95,sub,80,0,80
S,G142D,142,sub,80,72,152
S,V143-,143,del,80,0,80
S,Y144-,144,del,80,0,80
S,Y145-,145,del,80,0,80
S,N211I,211,sub,58,0,58
S,L212-,212,del,58,0,58
S,V213G,213,sub,0,77,77
S,214:EPE,214,in,54,0,54
S,G339D,339,sub,72,79,151
S,S371F,371,sub,5,79,84
S,S371L,371,sub,63,0,63
S,S373P,373,sub,68,79,147
S,S375F,375,sub,68,79,147
S,T376A,376,sub,5,79,84
S,D405N,405,sub,5,79,84
S,R408S,408,sub,5,79,84
S,K417N,417,sub,67,79,146
S,N440K,440,sub,37,17,54
S,G446S,446,sub,56,0,56
S,S477N,477,sub,61,72,133
S,T478K,478,sub,61,72,133
S,E484A,484,sub,59,71,130
S,Q493R,493,sub,59,71,130
S,G496S,496,sub,57,0,57
S,Q498R,498,sub,61,72,133
S,N501Y,501,sub,61,72,133
S,Y505H,505,sub,58,72,130
S,T547K,547,sub,80,0,80
S,D614G,614,sub,80,79,159
S,H655Y,655,sub,80,79,159
S,N679K,679,sub,80,79,159
S,P681H,681,sub,80,79,159
S,N764K,764,sub,80,78,158
S,D796Y,796,sub,80,79,159
S,Q853R,853,sub,6,0,6
S,N856K,856,sub,80,0,80
S,Q954H,954,sub,80,79,159
S,N969K,969,sub,80,78,158
S,L981F,981,sub,80,0,80
