gene,mutation,position,type,sc2_BA1_n80,sc2_BA2_n80,sum
E,T9I,9,sub,80,80,160
E,F23L,23,sub,0,1,1
E,V62F,62,sub,0,1,1
M,D3G,3,sub,70,1,71
M,Q19E,19,sub,78,71,149
M,A63T,63,sub,80,80,160
N,P13F,13,sub,0,1,1
N,P13L,13,sub,80,78,158
N,E31-,31,del,80,79,159
N,R32-,32,del,80,79,159
N,S33-,33,del,80,79,159
N,R89S,89,sub,0,1,1
N,G96C,96,sub,1,0,1
N,R203K,203,sub,80,79,159
N,G204R,204,sub,80,79,159
N,T205I,205,sub,0,1,1
N,Q384H,384,sub,0,1,1
N,T393I,393,sub,3,0,3
N,S413R,413,sub,0,78,78
N,T417I,417,sub,0,1,1
ORF1a,S3N,3,sub,1,0,1
ORF1a,G82V,82,sub,1,1,2
ORF1a,H83-,83,del,1,1,2
ORF1a,V84-,84,del,1,1,2
ORF1a,M85-,85,del,1,1,2
ORF1a,S135R,135,sub,0,80,80
ORF1a,K141-,141,del,1,0,1
ORF1a,S142-,142,del,1,0,1
ORF1a,F143-,143,del,1,0,1
ORF1a,G192D,192,sub,1,0,1
ORF1a,Y229H,229,sub,3,0,3
ORF1a,T265I,265,sub,0,1,1
ORF1a,P309L,309,sub,1,1,2
ORF1a,T333M,333,sub,1,0,1
ORF1a,S485N,485,sub,0,1,1
ORF1a,A690V,690,sub,1,0,1
ORF1a,I694T,694,sub,13,0,13
ORF1a,T727I,727,sub,1,0,1
ORF1a,T770I,770,sub,0,1,1
ORF1a,T842I,842,sub,0,79,79
ORF1a,K856R,856,sub,80,1,81
ORF1a,A859T,859,sub,1,0,1
ORF1a,P943S,943,sub,0,1,1
ORF1a,G957S,957,sub,1,0,1
ORF1a,G989D,989,sub,0,1,1
ORF1a,I1005S,1005,sub,1,0,1
ORF1a,H1113Y,1113,sub,0,1,1
ORF1a,G1119S,1119,sub,0,1,1
ORF1a,E1192D,1192,sub,0,1,1
ORF1a,G1307S,1307,sub,0,79,79
ORF1a,T1474I,1474,sub,0,1,1
ORF1a,T1496I,1496,sub,1,0,1
ORF1a,T1543I,1543,sub,0,7,7
ORF1a,Q1592R,1592,sub,3,0,3
ORF1a,T1605I,1605,sub,1,0,1
ORF1a,K1655N,1655,sub,0,1,1
ORF1a,T1682I,1682,sub,0,1,1
ORF1a,T1854I,1854,sub,1,0,1
ORF1a,T2007I,2007,sub,0,1,1
ORF1a,P2018L,2018,sub,1,0,1
ORF1a,P2046L,2046,sub,0,1,1
ORF1a,S2083I,2083,sub,80,0,80
ORF1a,L2084-,2084,del,80,0,80
ORF1a,A2097V,2097,sub,0,1,1
ORF1a,A2129V,2129,sub,2,0,2
ORF1a,I2138V,2138,sub,8,0,8
ORF1a,S2242F,2242,sub,1,0,1
ORF1a,S2273F,2273,sub,0,1,1
ORF1a,S2535L,2535,sub,2,0,2
ORF1a,S2600Q,2600,sub,0,1,1
ORF1a,P2685T,2685,sub,0,2,2
ORF1a,A2710T,2710,sub,80,1,81
ORF1a,T2791I,2791,sub,0,1,1
ORF1a,A2821V,2821,sub,0,1,1
ORF1a,A2909V,2909,sub,0,3,3
ORF1a,S2926F,2926,sub,0,3,3
ORF1a,L3027F,3027,sub,0,76,76
ORF1a,T3058I,3058,sub,1,0,1
ORF1a,T3090I,3090,sub,0,79,79
ORF1a,L3201F,3201,sub,0,78,78
ORF1a,T3255I,3255,sub,80,79,159
ORF1a,T3284I,3284,sub,0,1,1
ORF1a,K3353R,3353,sub,0,4,4
ORF1a,P3395H,3395,sub,80,80,160
ORF1a,A3497V,3497,sub,1,0,1
ORF1a,L3606F,3606,sub,3,2,5
ORF1a,A3610T,3610,sub,0,1,1
ORF1a,A3625V,3625,sub,0,1,1
ORF1a,L3644F,3644,sub,0,1,1
ORF1a,L3674-,3674,del,80,0,80
ORF1a,S3675-,3675,del,80,80,160
ORF1a,G3676-,3676,del,80,80,160
ORF1a,F3677-,3677,del,0,80,80
ORF1a,M3733K,3733,sub,0,1,1
ORF1a,I3758V,3758,sub,80,1,81
ORF1a,M3921I,3921,sub,1,0,1
ORF1a,K4138R,4138,sub,0,1,1
ORF1b,T67I,67,sub,2,0,2
ORF1b,P314L,314,sub,80,80,160
ORF1b,S638N,638,sub,0,1,1
ORF1b,L820F,820,sub,0,1,1
ORF1b,G1093S,1093,sub,1,0,1
ORF1b,A1259S,1259,sub,0,1,1
ORF1b,R1315C,1315,sub,0,79,79
ORF1b,K1383R,1383,sub,1,0,1
ORF1b,I1566V,1566,sub,80,80,160
ORF1b,T1621I,1621,sub,1,0,1
ORF1b,L1681F,1681,sub,0,2,2
ORF1b,P1682L,1682,sub,0,1,1
ORF1b,L1933F,1933,sub,2,0,2
ORF1b,L2032F,2032,sub,1,0,1
ORF1b,T2163I,2163,sub,0,78,78
ORF1b,S2198G,2198,sub,1,0,1
ORF1b,K2557R,2557,sub,0,1,1
ORF1b,M2667T,2667,sub,0,1,1
ORF3a,T9-,9,del,3,0,3
ORF3a,I10-,10,del,3,0,3
ORF3a,G11-,11,del,3,0,3
ORF3a,T12-,12,del,3,0,3
ORF3a,V13-,13,del,3,0,3
ORF3a,T14-,14,del,3,0,3
ORF3a,L15-,15,del,3,0,3
ORF3a,K16-,16,del,3,0,3
ORF3a,Q17-,17,del,3,0,3
ORF3a,G18-,18,del,3,0,3
ORF3a,E19-,19,del,3,0,3
ORF3a,I20-,20,del,3,0,3
ORF3a,A33S,33,sub,1,0,1
ORF3a,L65F,65,sub,0,1,1
ORF3a,V88L,88,sub,0,1,1
ORF3a,R134C,134,sub,1,0,1
ORF3a,D155Y,155,sub,0,1,1
ORF3a,S171L,171,sub,0,1,1
ORF3a,Q213K,213,sub,1,0,1
ORF3a,T223I,223,sub,0,79,79
ORF6,D61H,61,sub,0,1,1
ORF6,D61L,61,sub,0,77,77
ORF7a,S37F,37,sub,1,0,1
ORF7a,G38V,38,sub,1,0,1
ORF7a,H47Y,47,sub,3,0,3
ORF7a,Q62*,62,sub,1,0,1
ORF7a,A64S,64,sub,0,2,2
ORF7a,Q94H,94,sub,1,0,1
ORF7a,T120I,120,sub,0,1,1
ORF7b,T40I,40,sub,2,2,4
ORF8,Y31H,31,sub,2,0,2
ORF8,A51V,51,sub,1,0,1
ORF8,A65V,65,sub,1,0,1
ORF8,F120-,120,del,0,1,1
ORF8,I121-,121,del,2,0,2
ORF9b,P10F,10,sub,0,3,3
ORF9b,P10S,10,sub,80,76,156
ORF9b,E27-,27,del,80,79,159
ORF9b,N28-,28,del,80,79,159
ORF9b,A29-,29,del,80,79,159
ORF9b,R58K,58,sub,1,0,1
ORF9b,E86V,86,sub,0,1,1
S,T19I,19,sub,0,79,79
S,T19R,19,sub,0,1,1
S,L24S,24,sub,0,79,79
S,P25-,25,del,0,79,79
S,P26-,26,del,0,79,79
S,A27-,27,del,0,79,79
S,A67V,67,sub,80,1,81
S,H69-,69,del,80,1,81
S,V70-,70,del,80,1,81
S,S71P,71,sub,0,1,1
S,T95I,95,sub,80,1,81
S,G142-,142,del,0,1,1
S,G142D,142,sub,80,72,152
S,V143-,143,del,80,0,80
S,Y144-,144,del,80,0,80
S,Y145-,145,del,80,0,80
S,N211I,211,sub,58,0,58
S,L212-,212,del,58,0,58
S,V213G,213,sub,3,77,80
S,214:EPE,214,in,54,0,54
S,214:XE,214,in,2,0,2
S,D215G,215,sub,0,1,1
S,S221L,221,sub,1,0,1
S,L242-,242,del,0,1,1
S,A243-,243,del,0,1,1
S,L244-,244,del,0,1,1
S,E309K,309,sub,1,0,1
S,T333S,333,sub,1,0,1
S,G339D,339,sub,72,79,151
S,E340Q,340,sub,3,0,3
S,S371F,371,sub,5,79,84
S,S371L,371,sub,63,0,63
S,S373P,373,sub,68,79,147
S,S375F,375,sub,68,79,147
S,T376A,376,sub,5,79,84
S,D405N,405,sub,5,79,84
S,R408S,408,sub,5,79,84
S,K417N,417,sub,67,79,146
S,N440K,440,sub,37,17,54
S,G446S,446,sub,56,0,56
S,S477N,477,sub,61,72,133
S,T478K,478,sub,61,72,133
S,E484A,484,sub,59,71,130
S,E484K,484,sub,0,1,1
S,E484V,484,sub,1,0,1
S,Q493R,493,sub,59,71,130
S,G496S,496,sub,57,0,57
S,Q498R,498,sub,61,72,133
S,N501Y,501,sub,61,72,133
S,Y505H,505,sub,58,72,130
S,T547K,547,sub,80,0,80
S,D614G,614,sub,80,79,159
S,H655Y,655,sub,80,79,159
S,E661D,661,sub,0,1,1
S,N679K,679,sub,80,79,159
S,P681H,681,sub,80,79,159
S,A688V,688,sub,3,0,3
S,S730F,730,sub,1,0,1
S,N764K,764,sub,80,78,158
S,D796Y,796,sub,80,79,159
S,Q853R,853,sub,6,0,6
S,N856K,856,sub,80,0,80
S,Q954H,954,sub,80,79,159
S,N969K,969,sub,80,78,158
S,L981F,981,sub,80,1,81
S,P1162L,1162,sub,0,3,3
